WTXTXTZTTTXT
TTTXTTTTT1XT
TTTXTTXTXXXT
XXTTTTXTTTTT
TTTTXXXTXXXT